acces->access
accpet->accept
accpet->accept
ajustments->adjustments
annoucement->announcement
appcept->accept
aquisition->acquisition
as check->as checked
assignes->assigns
assumpted->assumed
beause->because
binery->binary
boundries->boundaries
buld->build
calbibration->calibration
calcalation->calculation
calclulation->calculation
calulation->calculation
candiates->candidates
carthesian->cartesian
collaguaes->colleagues
comparision->comparison
conent->content
configuartion->configuration
conscise->concise
coulnd't->couldn't
cygin->cygwin
cyphtered->cyphered
deaktivated->deactivated
debuging->debugging
decryt->decrypt
demulitplexer->demultiplexer
depencies->dependencies
derefencing->dereferencing
descendents->descendants
displayd->displayed
dize of->size of
doubele->double
doxgen->doxygen
doxyen->doxygen
encryt->encrypt
entriy->entry
environement->environment
eqaul->equal
errror->error
establised->established
establised->established
establishd->established
exectued->executed
generatation->generation
gut->get
helpfuly->helpfully
highligt->highlight
higlight->highlight
impresson->impression
incude->include
inefficent->inefficient
initalization->initialization
intantion->instantiation
interative->interactive
intervalls->intervals
IPAddres->IPAddress
IP-Addres->IP-Address
IPAdress->IPAddress
IP-Adress->IP-Address
irrascible->irascible
keybord->keyboard
loose->lose
mapps->maps
matrixes->matrices
methodes->methods
missmatch->mismatch
monocrome->monochrome
mulitplexer->multiplexer
mulitplicator->multiplicator
mulitthread->multithread
multi-thread->multithread
multythread->multithread
multy-thread->multithread
noninteractive->non-interactive
obivous->obvious
occures->occurs
oeperator->operator
openend->opened
parantheses->parentheses
parantheses->parenthesis
passord->password
pixcels->pixels
poping->popping
prcessing->processing
preceedence->precedence
preverse->preserve
prliminary->preliminary
projcedure->procedure
QUERTY->quwerty
reexecuted->re-executed
registred->registered
regsiter->register
reporsitory->repository
reson->reason
restared->restarted
scratcbox->scratchbox
semgentation->segmentation
serveral->several
severety->severity
sever not reachable-> server not reachable
shareing->sharing
simpliy->simplifiy
somthing->something
squres->squares
sublassed->subclassed
sublass->subclass
substraction->subtraction
taks->task
terrestrical->terrestrial
tray->try
tueday->tuesday
typahead->typeahead
unaccessible->inaccessible
unknwon->unknown
unsued->unused
unusal->unusual
varaible->variable
variabla->variable
variablen->variable
visisble->visible
webserver->web server
wether->whether
